{
  "tileSize": 32,
  "width": 39,
  "height": 29,
  "terrain": [
    [1, 1, 1, 1, 1, 1, 1, 1, 1, 1, 1, 1, 1, 1, 1, 1, 1, 1, 1, 1, 1, 1, 1, 1, 1, 1, 1, 1, 1, 1, 1, 1, 1, 1, 1, 1, 1, 1, 1],
    [1, 12, 0, 0, 0, 0, 0, 0, 0, 0, 0, 0, 0, 0, 0, 0, 0, 0, 0, 0, 0, 0, 0, 0, 0, 0, 0, 0, 0, 0, 0, 0, 0, 0, 0, 0, 0, 0, 1],
    [1, 0, 0, 0, 0, 0, 0, 0, 0, 0, 0, 0, 0, 0, 0, 0, 0, 0, 0, 0, 0, 0, 0, 0, 0, 0, 0, 0, 0, 0, 0, 0, 0, 0, 0, 0, 0, 0, 1],
    [1, 0, 0, 0, 0, 0, 0, 0, 0, 0, 0, 0, 0, 0, 0, 0, 0, 0, 0, 0, 0, 0, 0, 0, 0, 0, 0, 0, 0, 0, 0, 0, 0, 0, 0, 0, 0, 0, 1],
    [1, 0, 0, 0, 0, 0, 0, 0, 0, 0, 0, 0, 0, 0, 0, 0, 0, 0, 0, 0, 0, 0, 0, 0, 0, 0, 0, 0, 0, 0, 0, 0, 0, 0, 0, 0, 0, 0, 1],
    [1, 0, 0, 0, 0, 0, 0, 0, 0, 0, 0, 0, 0, 0, 0, 0, 0, 0, 0, 0, 0, 0, 0, 0, 0, 0, 0, 0, 0, 0, 0, 0, 11, 1, 10, 0, 0, 0, 1],
    [1, 0, 0, 0, 0, 0, 0, 0, 0, 0, 0, 0, 11, 22, 22, 22, 20, 0, 0, 0, 0, 0, 0, 0, 0, 0, 0, 21, 22, 22, 1, 1, 1, 1, 12, 0, 0, 0, 1],
    [1, 1, 1, 1, 1, 1, 33, 33, 33, 33, 1, 1, 12, 0, 0, 0, 13, 20, 0, 0, 0, 0, 0, 0, 0, 0, 21, 12, 0, 0, 13, 1, 1, 12, 0, 0, 0, 11, 1],
    [1, 0, 0, 0, 0, 0, 0, 0, 0, 0, 0, 0, 0, 0, 0, 0, 0, 13, 10, 0, 0, 0, 0, 0, 0, 11, 12, 0, 0, 0, 0, 0, 0, 0, 0, 0, 11, 12, 1],
    [1, 0, 0, 0, 0, 0, 0, 0, 0, 0, 0, 0, 0, 0, 0, 0, 0, 0, 13, 10, 0, 0, 0, 0, 11, 12, 0, 0, 0, 0, 0, 0, 0, 0, 0, 11, 12, 0, 1],
    [1, 0, 0, 0, 0, 0, 0, 0, 0, 0, 0, 0, 0, 0, 0, 0, 0, 0, 0, 13, 31, 31, 31, 31, 12, 0, 0, 0, 0, 0, 0, 0, 0, 0, 11, 12, 0, 0, 1],
    [1, 0, 0, 0, 0, 0, 0, 0, 0, 0, 0, 0, 0, 0, 0, 0, 0, 0, 0, 0, 0, 0, 0, 0, 0, 0, 0, 0, 0, 0, 0, 0, 0, 11, 12, 0, 0, 0, 1],
    [1, 0, 0, 0, 0, 0, 0, 0, 0, 0, 0, 0, 0, 0, 0, 0, 0, 0, 0, 0, 0, 0, 0, 0, 0, 0, 0, 0, 0, 0, 0, 0, 11, 12, 0, 0, 0, 0, 1],
    [1, 22, 0, 0, 22, 22, 22, 22, 22, 22, 22, 22, 22, 20, 0, 0, 0, 0, 0, 0, 0, 0, 0, 0, 0, 0, 0, 0, 0, 0, 0, 11, 12, 0, 0, 0, 0, 0, 1],
    [1, 0, 0, 0, 0, 0, 0, 0, 0, 0, 0, 0, 13, 1, 20, 0, 0, 0, 0, 0, 0, 0, 0, 21, 1, 1, 1, 32, 32, 32, 32, 12, 0, 0, 0, 0, 0, 0, 1],
    [1, 0, 0, 0, 0, 0, 0, 0, 0, 0, 0, 0, 0, 13, 1, 20, 0, 0, 0, 0, 0, 0, 21, 12, 0, 0, 0, 0, 0, 0, 0, 0, 0, 0, 11, 1, 1, 1, 1],
    [1, 0, 0, 0, 0, 0, 0, 0, 0, 0, 0, 0, 0, 0, 0, 0, 0, 0, 0, 0, 0, 21, 12, 0, 0, 0, 0, 0, 0, 0, 0, 0, 0, 0, 0, 0, 0, 0, 1],
    [1, 0, 0, 0, 0, 0, 0, 0, 0, 0, 0, 0, 0, 0, 0, 0, 0, 0, 0, 0, 21, 12, 0, 0, 0, 0, 0, 0, 0, 0, 0, 0, 0, 0, 0, 0, 0, 0, 1],
    [1, 0, 0, 0, 0, 13, 1, 32, 32, 32, 32, 32, 32, 32, 32, 32, 1, 1, 1, 1, 12, 0, 0, 0, 0, 0, 0, 0, 0, 21, 1, 1, 1, 1, 10, 0, 0, 0, 1],
    [1, 0, 0, 0, 0, 0, 13, 1, 1, 1, 1, 1, 1, 1, 12, 0, 0, 0, 0, 0, 0, 0, 0, 0, 21, 22, 22, 22, 22, 12, 0, 0, 0, 0, 0, 0, 0, 0, 1],
    [1, 0, 0, 0, 0, 0, 0, 0, 0, 0, 0, 13, 1, 1, 0, 0, 0, 0, 0, 0, 0, 0, 0, 21, 12, 0, 0, 0, 0, 0, 0, 0, 0, 0, 0, 0, 0, 0, 1],
    [1, 0, 0, 0, 0, 0, 0, 0, 0, 0, 0, 0, 13, 1, 0, 0, 0, 0, 0, 0, 0, 0, 21, 12, 0, 0, 0, 0, 0, 0, 0, 0, 11, 1, 1, 1, 1, 1, 1],
    [1, 0, 0, 0, 0, 0, 0, 0, 0, 0, 0, 0, 0, 0, 0, 0, 0, 0, 0, 21, 22, 22, 1, 0, 0, 0, 11, 1, 1, 1, 1, 1, 12, 0, 0, 0, 0, 0, 1],
    [1, 0, 0, 0, 0, 0, 0, 0, 0, 0, 0, 0, 0, 0, 0, 0, 0, 0, 21, 1, 1, 1, 1, 10, 0, 0, 0, 0, 0, 0, 0, 0, 0, 0, 0, 0, 0, 0, 1],
    [1, 0, 0, 0, 0, 0, 0, 0, 0, 0, 0, 0, 0, 0, 0, 0, 0, 21, 1, 12, 0, 0, 0, 13, 10, 0, 0, 0, 0, 0, 0, 0, 0, 0, 0, 0, 0, 0, 1],
    [1, 0, 0, 0, 0, 0, 0, 0, 0, 0, 0, 0, 0, 0, 0, 0, 0, 0, 0, 0, 0, 0, 0, 0, 13, 1, 1, 1, 1, 1, 1, 1, 1, 1, 10, 0, 0, 0, 1],
    [1, 0, 0, 0, 0, 0, 0, 0, 0, 0, 0, 0, 0, 0, 0, 0, 0, 0, 0, 0, 0, 0, 0, 0, 0, 0, 0, 0, 0, 0, 0, 0, 0, 0, 0, 0, 0, 0, 1],
    [1, 32, 32, 32, 32, 32, 32, 32, 1, 1, 1, 1, 1, 1, 1, 1, 1, 1, 1, 1, 1, 1, 10, 0, 0, 0, 0, 0, 0, 0, 0, 0, 0, 0, 0, 0, 0, 0, 1],
    [1, 1, 1, 1, 1, 1, 1, 1, 1, 1, 1, 1, 1, 1, 1, 1, 1, 1, 1, 1, 1, 1, 1, 1, 1, 1, 1, 1, 1, 1, 1, 1, 1, 1, 1, 1, 1, 1, 1]
  ],
  "objects": [
    {
      "type": "fire_spawn",
      "row": 5,
      "col": 1
    },
    {
      "type": "water_spawn",
      "row": 5,
      "col": 3
    },
    {
      "type": "diamond",
      "element": "water",
      "row": 4,
      "col": 10
    },
    {
      "type": "diamond",
      "element": "water",
      "row": 8,
      "col": 21
    },
    {
      "type": "diamond",
      "element": "water",
      "row": 10,
      "col": 32
    },
    {
      "type": "diamond",
      "element": "water",
      "row": 12,
      "col": 15
    },
    {
      "type": "diamond",
      "element": "water",
      "row": 23,
      "col": 9
    },
    {
      "type": "diamond",
      "element": "water",
      "row": 21,
      "col": 18
    },
    {
      "type": "diamond",
      "element": "water",
      "row": 17,
      "col": 27
    },
    {
      "type": "diamond",
      "element": "fire",
      "row": 20,
      "col": 31
    },
    {
      "type": "diamond",
      "element": "fire",
      "row": 25,
      "col": 21
    },
    {
      "type": "diamond",
      "element": "fire",
      "row": 25,
      "col": 11
    },
    {
      "type": "diamond",
      "element": "fire",
      "row": 16,
      "col": 11
    },
    {
      "type": "diamond",
      "element": "fire",
      "row": 12,
      "col": 30
    },
    {
      "type": "diamond",
      "element": "fire",
      "row": 3,
      "col": 36
    },
    {
      "type": "diamond",
      "element": "fire",
      "row": 6,
      "col": 23
    },
    {
      "type": "fire_door",
      "row": 16,
      "col": 31
    },
    {
      "type": "water_door",
      "row": 13,
      "col": 35
    },
    {
      "type": "block",
      "row": 26,
      "col": 5
    }
  ]
}