{
  "tileSize": 32,
  "width": 39,
  "height": 29,
  "terrain": [
    [1, 1, 1, 1, 1, 1, 1, 1, 1, 1, 1, 1, 1, 1, 1, 1, 1, 1, 1, 1, 1, 1, 1, 1, 1, 1, 1, 1, 1, 1, 1, 1, 1, 1, 1, 1, 1, 1, 1],
    [1, 0, 0, 0, 0, 0, 0, 0, 1, 0, 0, 0, 0, 0, 0, 0, 1, 1, 0, 0, 0, 0, 0, 0, 0, 0, 0, 0, 0, 0, 0, 0, 0, 0, 0, 0, 0, 0, 1],
    [1, 0, 0, 0, 0, 0, 0, 0, 0, 0, 0, 0, 0, 0, 0, 0, 13, 1, 10, 0, 0, 0, 0, 0, 0, 0, 0, 0, 0, 0, 0, 0, 0, 0, 0, 0, 0, 0, 1],
    [1, 0, 0, 0, 0, 0, 0, 0, 0, 0, 0, 0, 0, 0, 0, 0, 0, 1, 12, 0, 0, 0, 0, 0, 0, 0, 0, 0, 0, 0, 0, 0, 0, 0, 0, 0, 0, 0, 1],
    [1, 0, 0, 0, 0, 0, 0, 0, 0, 0, 0, 0, 0, 0, 0, 0, 0, 0, 0, 0, 0, 0, 0, 0, 0, 0, 0, 0, 0, 0, 0, 0, 0, 0, 0, 0, 0, 0, 1],
    [1, 1, 1, 1, 1, 1, 1, 1, 1, 10, 0, 0, 11, 10, 0, 0, 0, 0, 0, 0, 0, 0, 0, 0, 0, 0, 0, 0, 0, 0, 0, 0, 0, 0, 0, 0, 0, 0, 1],
    [1, 0, 0, 0, 13, 10, 0, 0, 0, 0, 0, 0, 1, 1, 10, 0, 0, 0, 0, 0, 0, 0, 0, 11, 1, 1, 10, 0, 0, 0, 0, 0, 0, 0, 0, 0, 0, 0, 1],
    [1, 0, 0, 0, 0, 13, 10, 0, 0, 0, 0, 0, 1, 1, 1, 0, 0, 0, 0, 0, 0, 0, 11, 1, 0, 0, 13, 20, 0, 0, 0, 0, 0, 0, 0, 0, 0, 0, 1],
    [1, 0, 0, 0, 0, 0, 13, 10, 0, 0, 0, 11, 1, 1, 1, 10, 0, 0, 0, 0, 0, 11, 1, 1, 0, 0, 0, 13, 20, 0, 0, 0, 0, 0, 0, 0, 0, 0, 1],
    [1, 0, 0, 0, 0, 0, 0, 13, 1, 1, 1, 1, 1, 1, 1, 1, 1, 33, 33, 33, 1, 1, 1, 1, 1, 1, 1, 1, 1, 22, 1, 12, 0, 0, 0, 0, 0, 0, 1],
    [1, 0, 0, 0, 0, 0, 0, 0, 0, 0, 0, 0, 0, 0, 0, 0, 0, 0, 0, 0, 0, 0, 0, 0, 0, 0, 0, 0, 0, 0, 0, 0, 0, 0, 11, 1, 1, 1, 1],
    [1, 20, 0, 0, 0, 0, 0, 0, 0, 0, 0, 0, 0, 0, 0, 0, 0, 0, 0, 0, 0, 0, 0, 0, 0, 0, 0, 0, 0, 0, 0, 0, 0, 0, 0, 0, 0, 0, 1],
    [1, 1, 20, 0, 0, 0, 0, 0, 0, 0, 0, 0, 0, 0, 0, 0, 0, 0, 0, 0, 0, 0, 0, 0, 0, 0, 0, 0, 0, 0, 0, 0, 0, 0, 0, 0, 0, 0, 1],
    [1, 1, 1, 20, 0, 0, 0, 0, 0, 0, 0, 0, 0, 0, 0, 0, 11, 1, 1, 1, 1, 1, 1, 1, 1, 1, 1, 1, 1, 1, 1, 1, 10, 0, 0, 0, 0, 21, 1],
    [1, 12, 0, 0, 0, 0, 0, 0, 0, 0, 0, 0, 0, 0, 0, 0, 0, 0, 0, 0, 0, 0, 0, 0, 0, 0, 0, 0, 0, 0, 0, 0, 0, 0, 0, 0, 21, 1, 1],
    [1, 0, 0, 0, 0, 0, 0, 0, 0, 0, 0, 0, 0, 0, 0, 0, 0, 0, 0, 0, 0, 0, 0, 0, 0, 0, 0, 0, 0, 0, 0, 0, 0, 0, 0, 21, 1, 1, 1],
    [1, 0, 0, 0, 0, 11, 1, 1, 30, 30, 30, 30, 30, 30, 30, 30, 30, 30, 30, 30, 1, 1, 32, 32, 32, 32, 32, 32, 1, 1, 1, 1, 1, 1, 1, 1, 1, 1, 1],
    [1, 0, 0, 0, 0, 1, 1, 1, 1, 1, 1, 1, 1, 1, 1, 1, 1, 1, 1, 1, 1, 12, 0, 0, 0, 0, 0, 0, 0, 0, 0, 0, 0, 0, 0, 0, 0, 0, 1],
    [1, 0, 0, 0, 0, 1, 0, 0, 0, 0, 0, 0, 0, 0, 0, 0, 0, 0, 0, 0, 0, 0, 0, 0, 0, 0, 0, 0, 0, 0, 0, 0, 0, 0, 0, 0, 0, 0, 1],
    [1, 0, 0, 0, 11, 12, 0, 0, 0, 0, 0, 0, 0, 0, 0, 0, 0, 0, 0, 0, 0, 0, 0, 0, 0, 0, 0, 0, 0, 0, 0, 0, 0, 0, 0, 0, 0, 0, 1],
    [1, 0, 0, 0, 0, 0, 0, 0, 0, 0, 0, 0, 0, 0, 0, 0, 0, 0, 0, 0, 0, 0, 0, 0, 0, 11, 1, 1, 1, 1, 12, 0, 0, 0, 0, 0, 0, 0, 1],
    [1, 0, 0, 0, 0, 0, 0, 0, 0, 0, 0, 0, 0, 0, 0, 0, 0, 0, 0, 0, 0, 0, 0, 0, 11, 12, 0, 0, 0, 0, 0, 0, 0, 0, 0, 0, 0, 0, 1],
    [1, 10, 0, 0, 0, 0, 0, 0, 0, 0, 0, 0, 0, 0, 0, 0, 0, 0, 0, 0, 0, 0, 0, 11, 12, 0, 0, 0, 0, 0, 0, 0, 0, 11, 1, 1, 22, 22, 1],
    [1, 1, 1, 1, 1, 1, 1, 1, 31, 31, 31, 31, 31, 31, 31, 31, 31, 31, 31, 31, 1, 1, 1, 12, 0, 0, 0, 0, 0, 0, 0, 0, 0, 0, 0, 0, 0, 0, 1],
    [1, 0, 0, 0, 0, 0, 0, 0, 0, 0, 0, 0, 0, 0, 0, 0, 0, 0, 0, 0, 0, 0, 0, 0, 0, 0, 0, 21, 1, 1, 1, 10, 0, 0, 0, 0, 0, 0, 1],
    [1, 0, 0, 0, 0, 0, 0, 0, 0, 0, 0, 0, 0, 0, 0, 0, 0, 0, 0, 0, 0, 0, 0, 0, 0, 0, 21, 1, 1, 1, 1, 1, 10, 0, 0, 0, 0, 21, 1],
    [1, 0, 0, 0, 0, 0, 0, 0, 0, 0, 0, 0, 0, 0, 0, 0, 0, 0, 0, 0, 0, 0, 0, 0, 0, 0, 0, 0, 0, 0, 0, 0, 0, 0, 0, 0, 21, 1, 1],
    [1, 0, 0, 0, 0, 0, 0, 0, 0, 0, 0, 0, 0, 0, 0, 0, 0, 0, 0, 0, 0, 0, 0, 0, 0, 0, 0, 0, 0, 0, 0, 0, 0, 0, 0, 21, 1, 1, 1],
    [1, 1, 1, 1, 1, 1, 1, 1, 1, 22, 22, 22, 22, 22, 22, 22, 22, 1, 1, 1, 1, 1, 1, 1, 1, 1, 1, 1, 32, 32, 32, 32, 32, 1, 1, 1, 1, 1, 1]
  ],
  "objects": [
    {
      "type": "fire_spawn",
      "row": 26,
      "col": 2
    },
    {
      "type": "water_spawn",
      "row": 26,
      "col": 4
    },
    {
      "type": "fire_door",
      "row": 3,
      "col": 2
    },
    {
      "type": "water_door",
      "row": 3,
      "col": 5
    },
    {
      "type": "diamond",
      "element": "water",
      "row": 7,
      "col": 30
    },
    {
      "type": "diamond",
      "element": "water",
      "row": 10,
      "col": 2
    },
    {
      "type": "diamond",
      "element": "fire",
      "row": 4,
      "col": 25
    },
    {
      "type": "diamond",
      "element": "fire",
      "row": 13,
      "col": 35
    },
    {
      "type": "diamond",
      "element": "fire",
      "row": 21,
      "col": 6
    },
    {
      "type": "diamond",
      "element": "fire",
      "row": 22,
      "col": 29
    },
    {
      "type": "diamond",
      "element": "water",
      "row": 26,
      "col": 21
    },
    {
      "type": "diamond",
      "element": "water",
      "row": 18,
      "col": 32
    },
    {
      "type": "button",
      "row": 15,
      "col": 30,
      "group_id": 1
    },
    {
      "type": "button",
      "row": 22,
      "col": 4,
      "group_id": 3
    },
    {
      "type": "elevator",
      "row": 11,
      "col": 10,
      "target_row": 11,
      "target_col": 8,
      "is_horizontal": true,
      "length": 2,
      "group_id": 1
    },
    {
      "type": "elevator",
      "row": 19,
      "col": 11,
      "target_row": 19,
      "target_col": 9,
      "is_horizontal": true,
      "length": 2,
      "group_id": 3
    },
    {
      "type": "elevator",
      "row": 2,
      "col": 8,
      "target_row": -1,
      "target_col": 8,
      "is_horizontal": false,
      "length": 3,
      "group_id": 2
    },
    {
      "type": "lever",
      "row": 9,
      "col": 36,
      "group_id": 2
    }
  ]
}