{
  "tileSize": 32,
  "width": 39,
  "height": 29,
  "terrain": [
    [1, 1, 1, 1, 1, 1, 1, 1, 1, 1, 1, 1, 1, 1, 1, 1, 1, 1, 1, 1, 1, 1, 1, 1, 1, 1, 1, 1, 1, 1, 1, 1, 1, 1, 1, 1, 1, 1, 1],
    [1, 0, 0, 0, 0, 0, 0, 0, 0, 0, 0, 0, 1, 0, 0, 0, 0, 0, 0, 0, 0, 0, 0, 0, 0, 0, 0, 0, 0, 0, 0, 1, 0, 0, 0, 0, 0, 13, 1],
    [1, 0, 0, 0, 0, 0, 0, 0, 0, 0, 0, 0, 1, 0, 0, 0, 0, 0, 0, 0, 0, 0, 0, 0, 0, 0, 0, 0, 0, 0, 0, 0, 0, 0, 0, 0, 0, 0, 1],
    [1, 0, 0, 0, 0, 0, 0, 0, 0, 0, 0, 0, 1, 0, 0, 0, 0, 0, 0, 0, 0, 0, 0, 0, 0, 0, 0, 0, 0, 0, 0, 0, 0, 0, 0, 0, 0, 0, 1],
    [1, 0, 0, 0, 0, 0, 0, 0, 0, 0, 0, 0, 1, 0, 0, 0, 0, 0, 0, 0, 0, 0, 0, 0, 0, 0, 0, 0, 0, 0, 0, 0, 0, 0, 0, 0, 0, 0, 1],
    [1, 0, 0, 0, 0, 0, 0, 0, 0, 0, 0, 0, 13, 1, 1, 1, 1, 1, 1, 1, 1, 1, 1, 1, 1, 1, 1, 1, 1, 1, 1, 1, 10, 0, 0, 0, 0, 0, 1],
    [1, 0, 0, 0, 0, 0, 0, 0, 0, 0, 0, 0, 0, 0, 0, 0, 0, 1, 0, 0, 0, 0, 0, 0, 0, 0, 0, 0, 0, 0, 0, 0, 1, 0, 0, 11, 1, 1, 1],
    [1, 0, 0, 0, 0, 1, 1, 1, 1, 10, 0, 0, 0, 0, 0, 0, 0, 1, 0, 0, 0, 0, 0, 0, 0, 0, 0, 0, 0, 0, 0, 0, 1, 0, 0, 0, 0, 0, 1],
    [1, 0, 0, 0, 0, 1, 0, 0, 0, 13, 10, 0, 0, 0, 0, 0, 0, 1, 0, 0, 0, 0, 0, 0, 0, 0, 0, 0, 0, 0, 0, 0, 1, 0, 0, 0, 0, 0, 1],
    [1, 0, 0, 0, 0, 1, 0, 0, 0, 0, 0, 0, 0, 0, 0, 0, 0, 13, 1, 1, 10, 0, 0, 0, 0, 0, 0, 0, 11, 1, 1, 1, 1, 1, 10, 0, 0, 0, 1],
    [1, 0, 0, 0, 0, 1, 0, 0, 0, 0, 0, 0, 0, 0, 0, 0, 0, 0, 0, 0, 0, 0, 0, 21, 22, 1, 1, 1, 12, 0, 0, 0, 0, 0, 0, 0, 0, 0, 1],
    [1, 0, 0, 0, 0, 1, 1, 1, 1, 1, 1, 1, 10, 0, 0, 0, 0, 0, 0, 0, 0, 0, 0, 0, 0, 0, 0, 0, 0, 0, 0, 0, 0, 0, 0, 0, 0, 11, 1],
    [1, 0, 0, 0, 0, 1, 0, 0, 0, 0, 0, 0, 0, 0, 0, 0, 0, 0, 0, 0, 0, 0, 0, 0, 0, 0, 0, 0, 0, 0, 0, 0, 0, 0, 0, 0, 11, 1, 1],
    [1, 0, 0, 0, 0, 1, 0, 0, 0, 0, 0, 0, 0, 0, 0, 0, 0, 11, 1, 30, 30, 30, 30, 30, 30, 30, 30, 30, 30, 30, 30, 30, 30, 1, 1, 1, 1, 1, 1],
    [1, 0, 0, 0, 0, 1, 0, 0, 0, 0, 0, 11, 1, 1, 1, 1, 1, 1, 1, 1, 1, 1, 1, 1, 1, 1, 1, 1, 1, 1, 1, 1, 1, 1, 1, 1, 1, 1, 1],
    [1, 0, 0, 0, 0, 1, 0, 0, 0, 0, 11, 12, 0, 0, 0, 0, 0, 0, 0, 0, 0, 0, 0, 0, 1, 0, 13, 0, 0, 12, 0, 0, 13, 0, 0, 12, 0, 13, 1],
    [1, 0, 0, 0, 0, 1, 0, 0, 0, 11, 12, 0, 0, 0, 0, 0, 0, 0, 0, 0, 0, 0, 0, 0, 1, 0, 0, 0, 0, 0, 0, 0, 0, 0, 0, 0, 0, 0, 1],
    [1, 0, 0, 0, 0, 1, 0, 0, 0, 0, 0, 0, 0, 11, 1, 1, 1, 1, 1, 1, 1, 0, 0, 1, 12, 0, 0, 0, 0, 0, 0, 0, 0, 0, 0, 0, 0, 0, 1],
    [1, 0, 0, 0, 0, 1, 0, 0, 0, 0, 0, 0, 11, 12, 0, 0, 0, 0, 0, 0, 0, 0, 0, 0, 0, 0, 0, 0, 0, 0, 0, 0, 0, 0, 0, 0, 0, 0, 1],
    [1, 0, 0, 0, 0, 0, 0, 0, 0, 0, 0, 11, 12, 0, 0, 0, 0, 0, 0, 0, 0, 0, 0, 0, 0, 0, 0, 0, 0, 0, 0, 0, 0, 0, 0, 0, 0, 0, 1],
    [1, 0, 0, 0, 0, 0, 0, 0, 0, 0, 0, 0, 0, 0, 0, 0, 0, 0, 0, 0, 0, 0, 0, 0, 0, 0, 0, 0, 0, 0, 0, 0, 0, 0, 0, 0, 0, 0, 1],
    [1, 0, 0, 0, 0, 0, 0, 0, 0, 0, 0, 0, 0, 0, 0, 0, 0, 0, 0, 0, 0, 0, 0, 0, 0, 0, 0, 0, 0, 0, 0, 0, 0, 0, 0, 0, 0, 11, 1],
    [1, 0, 0, 0, 0, 0, 0, 11, 1, 1, 1, 1, 1, 1, 1, 1, 1, 1, 1, 1, 1, 1, 1, 1, 1, 1, 1, 1, 1, 1, 1, 1, 1, 1, 1, 1, 1, 1, 1],
    [1, 0, 0, 0, 0, 0, 11, 12, 0, 0, 0, 0, 0, 0, 0, 0, 0, 0, 0, 0, 0, 0, 0, 0, 0, 0, 0, 0, 0, 0, 0, 0, 0, 0, 0, 0, 0, 0, 1],
    [1, 0, 0, 0, 0, 11, 12, 0, 0, 0, 0, 0, 0, 0, 0, 0, 0, 0, 0, 0, 0, 0, 0, 0, 0, 0, 0, 0, 0, 0, 0, 0, 0, 0, 0, 0, 0, 0, 1],
    [1, 0, 0, 0, 0, 0, 0, 0, 0, 0, 0, 0, 0, 0, 0, 0, 0, 0, 0, 0, 0, 0, 0, 0, 0, 0, 0, 0, 0, 0, 0, 0, 0, 0, 0, 0, 0, 0, 1],
    [1, 0, 0, 0, 0, 0, 0, 0, 0, 0, 0, 0, 0, 0, 0, 0, 0, 0, 0, 0, 0, 11, 1, 32, 32, 32, 32, 32, 32, 1, 1, 1, 1, 10, 0, 0, 0, 0, 1],
    [1, 1, 31, 31, 31, 31, 31, 31, 31, 31, 31, 31, 31, 31, 31, 31, 10, 0, 0, 0, 11, 1, 1, 1, 1, 1, 1, 1, 1, 1, 1, 1, 1, 1, 10, 0, 0, 0, 1],
    [1, 1, 1, 1, 1, 1, 1, 1, 1, 1, 1, 1, 1, 1, 1, 1, 1, 1, 1, 1, 1, 1, 1, 1, 1, 1, 1, 1, 1, 1, 1, 1, 1, 1, 1, 1, 1, 1, 1]
  ],
  "objects": [
    {
      "type": "fire_spawn",
      "row": 20,
      "col": 29
    },
    {
      "type": "water_spawn",
      "row": 20,
      "col": 31
    },
    {
      "type": "fire_door",
      "row": 3,
      "col": 14
    },
    {
      "type": "water_door",
      "row": 3,
      "col": 17
    },
    {
      "type": "diamond",
      "element": "water",
      "row": 4,
      "col": 37
    },
    {
      "type": "diamond",
      "element": "water",
      "row": 7,
      "col": 19
    },
    {
      "type": "diamond",
      "element": "water",
      "row": 17,
      "col": 12
    },
    {
      "type": "diamond",
      "element": "water",
      "row": 16,
      "col": 3
    },
    {
      "type": "diamond",
      "element": "water",
      "row": 25,
      "col": 18
    },
    {
      "type": "diamond",
      "element": "fire",
      "row": 11,
      "col": 35
    },
    {
      "type": "diamond",
      "element": "fire",
      "row": 16,
      "col": 20
    },
    {
      "type": "diamond",
      "element": "fire",
      "row": 24,
      "col": 31
    },
    {
      "type": "diamond",
      "element": "fire",
      "row": 5,
      "col": 7
    },
    {
      "type": "diamond",
      "element": "fire",
      "row": 25,
      "col": 11
    },
    {
      "type": "elevator",
      "row": 2,
      "col": 31,
      "target_row": -1,
      "target_col": 31,
      "length": 1,
      "is_horizontal": false,
      "group_id": 3
    },
    {
      "type": "elevator",
      "row": 9,
      "col": 10,
      "target_row": 12,
      "target_col": 10,
      "length": 1,
      "is_horizontal": false,
      "group_id": 1
    },
    {
      "type": "elevator",
      "row": 16,
      "col": 6,
      "target_row": 19,
      "target_col": 6,
      "length": 3,
      "is_horizontal": true,
      "group_id": 5
    },
    {
      "type": "elevator",
      "row": 17,
      "col": 20,
      "target_row": 17,
      "target_col": 20,
      "length": 3,
      "is_horizontal": true,
      "group_id": 2
    },
    {
      "type": "lever",
      "row": 27,
      "col": 35,
      "group_id": 5
    },
    {
      "type": "button",
      "row": 27,
      "col": 17,
      "group_id": 2
    },
    {
      "type": "button",
      "row": 8,
      "col": 29,
      "group_id": 1
    },
    {
      "type": "lever",
      "row": 10,
      "col": 6,
      "group_id": 3
    },
    {
      "type": "lever",
      "row": 13,
      "col": 13
    }
  ]
}