{
  "tileSize": 32,
  "width": 39,
  "height": 29,
  "terrain": [
    [1, 1, 1, 1, 1, 1, 1, 1, 1, 1, 1, 1, 1, 1, 1, 1, 1, 1, 1, 1, 1, 1, 1, 1, 1, 1, 1, 1, 1, 1, 1, 1, 1, 1, 1, 1, 1, 1, 1],
    [1, 0, 0, 0, 0, 0, 0, 0, 0, 0, 0, 0, 0, 0, 0, 0, 0, 0, 0, 0, 0, 0, 0, 0, 0, 0, 0, 0, 0, 0, 0, 0, 0, 0, 0, 0, 13, 1, 1],
    [1, 0, 0, 0, 0, 0, 0, 0, 0, 0, 0, 0, 0, 0, 0, 0, 0, 0, 0, 0, 0, 0, 0, 0, 0, 0, 0, 0, 0, 0, 0, 0, 0, 0, 0, 0, 0, 13, 1],
    [1, 0, 0, 0, 0, 0, 0, 0, 0, 0, 0, 0, 0, 0, 0, 0, 0, 0, 0, 0, 0, 0, 0, 0, 0, 0, 0, 0, 0, 0, 0, 0, 0, 0, 0, 0, 0, 0, 1],
    [1, 0, 0, 0, 0, 0, 0, 11, 1, 1, 1, 1, 22, 22, 22, 1, 1, 1, 22, 22, 1, 1, 1, 12, 0, 0, 0, 0, 0, 0, 0, 0, 0, 0, 0, 0, 0, 0, 1],
    [1, 0, 0, 0, 0, 0, 0, 0, 0, 0, 0, 0, 0, 0, 0, 0, 0, 0, 0, 0, 0, 0, 0, 0, 0, 0, 0, 0, 0, 0, 0, 0, 0, 0, 0, 0, 0, 0, 1],
    [1, 0, 0, 0, 0, 0, 0, 0, 0, 0, 0, 0, 0, 0, 0, 0, 0, 0, 0, 0, 0, 0, 0, 0, 0, 0, 11, 31, 31, 31, 31, 31, 31, 31, 1, 1, 1, 1, 1],
    [1, 1, 1, 1, 10, 0, 0, 0, 0, 0, 0, 0, 0, 0, 0, 0, 0, 0, 0, 0, 0, 0, 0, 0, 0, 0, 0, 0, 0, 0, 0, 0, 0, 0, 0, 0, 0, 13, 1],
    [1, 1, 1, 1, 1, 1, 1, 1, 1, 1, 10, 0, 0, 0, 0, 0, 0, 0, 13, 22, 22, 22, 1, 10, 0, 0, 0, 0, 0, 0, 0, 0, 0, 0, 0, 0, 0, 0, 1],
    [1, 0, 0, 0, 0, 0, 0, 0, 0, 0, 0, 0, 0, 0, 0, 0, 0, 0, 0, 0, 0, 0, 0, 0, 0, 0, 0, 0, 0, 0, 0, 0, 0, 0, 0, 0, 0, 0, 1],
    [1, 0, 0, 0, 0, 0, 0, 0, 0, 0, 0, 0, 0, 0, 0, 0, 0, 0, 0, 0, 0, 0, 0, 0, 0, 0, 0, 11, 1, 1, 1, 1, 1, 1, 1, 10, 0, 0, 1],
    [1, 0, 0, 21, 22, 22, 22, 22, 22, 22, 22, 1, 32, 32, 32, 32, 32, 32, 32, 32, 32, 32, 32, 1, 1, 1, 1, 1, 12, 0, 0, 0, 0, 0, 0, 0, 0, 0, 1],
    [1, 0, 21, 12, 0, 0, 0, 0, 0, 0, 0, 0, 0, 0, 13, 1, 1, 1, 1, 1, 1, 1, 1, 1, 1, 1, 1, 12, 0, 0, 0, 0, 0, 0, 0, 0, 0, 11, 1],
    [1, 11, 12, 0, 0, 0, 0, 0, 0, 0, 0, 0, 0, 0, 0, 0, 0, 13, 1, 1, 1, 12, 0, 0, 0, 0, 0, 0, 0, 0, 0, 0, 0, 11, 1, 1, 1, 1, 1],
    [1, 12, 0, 0, 0, 0, 0, 0, 0, 0, 0, 0, 0, 0, 0, 0, 0, 0, 0, 0, 0, 0, 0, 0, 0, 0, 0, 0, 0, 0, 0, 0, 0, 0, 0, 0, 0, 0, 1],
    [1, 0, 0, 0, 0, 0, 0, 0, 0, 0, 0, 0, 0, 0, 0, 0, 0, 0, 0, 0, 0, 0, 0, 0, 0, 0, 0, 0, 0, 0, 0, 0, 0, 0, 0, 0, 0, 0, 1],
    [1, 0, 0, 0, 11, 1, 1, 1, 1, 22, 22, 22, 22, 22, 22, 22, 22, 22, 22, 22, 22, 22, 22, 22, 22, 22, 22, 22, 1, 1, 1, 1, 1, 1, 10, 0, 0, 0, 1],
    [1, 0, 0, 0, 0, 0, 0, 0, 0, 0, 0, 0, 0, 0, 0, 0, 0, 0, 0, 0, 0, 0, 0, 0, 0, 13, 1, 12, 0, 0, 0, 0, 0, 0, 0, 0, 0, 0, 1],
    [1, 0, 0, 0, 0, 0, 0, 0, 0, 0, 0, 0, 0, 0, 0, 0, 0, 0, 0, 0, 0, 0, 0, 0, 0, 0, 1, 0, 0, 0, 0, 0, 0, 0, 0, 0, 0, 0, 1],
    [1, 10, 0, 0, 0, 0, 0, 0, 0, 0, 0, 0, 0, 0, 0, 0, 0, 0, 0, 0, 0, 0, 0, 0, 0, 0, 1, 0, 0, 0, 0, 0, 0, 0, 0, 0, 0, 11, 1],
    [1, 1, 1, 1, 1, 1, 1, 1, 1, 1, 1, 1, 1, 1, 1, 1, 1, 1, 20, 0, 0, 0, 0, 0, 0, 0, 13, 1, 1, 1, 31, 31, 31, 31, 31, 31, 31, 1, 1],
    [1, 0, 0, 0, 0, 0, 0, 0, 0, 0, 0, 0, 0, 0, 0, 0, 0, 0, 13, 20, 0, 0, 0, 0, 0, 0, 0, 0, 0, 0, 0, 0, 0, 0, 0, 0, 0, 0, 1],
    [1, 0, 0, 0, 0, 0, 0, 0, 0, 0, 0, 0, 0, 0, 0, 0, 0, 0, 0, 13, 22, 22, 1, 1, 10, 0, 0, 0, 0, 0, 0, 0, 0, 0, 0, 0, 0, 0, 1],
    [1, 0, 0, 0, 0, 0, 0, 0, 0, 0, 0, 0, 0, 0, 0, 0, 0, 0, 0, 0, 0, 0, 0, 0, 13, 10, 0, 0, 0, 0, 0, 0, 0, 0, 0, 0, 0, 0, 1],
    [1, 0, 0, 0, 11, 1, 1, 1, 1, 12, 0, 0, 0, 0, 0, 0, 0, 0, 0, 0, 0, 0, 0, 0, 0, 13, 1, 1, 1, 1, 1, 1, 1, 1, 10, 0, 0, 0, 1],
    [1, 0, 0, 0, 0, 0, 0, 0, 0, 0, 0, 21, 22, 22, 1, 1, 22, 20, 0, 0, 0, 0, 0, 0, 0, 0, 0, 0, 0, 0, 0, 0, 0, 0, 0, 0, 0, 0, 1],
    [1, 10, 0, 0, 0, 0, 0, 0, 0, 0, 21, 1, 1, 1, 1, 1, 1, 1, 20, 0, 0, 0, 0, 0, 0, 0, 0, 0, 0, 0, 0, 0, 0, 0, 0, 0, 0, 0, 1],
    [1, 1, 10, 0, 0, 0, 0, 0, 0, 21, 1, 1, 1, 1, 1, 1, 1, 1, 1, 1, 1, 1, 10, 0, 0, 0, 0, 0, 0, 0, 0, 0, 0, 0, 0, 0, 0, 11, 1],
    [1, 1, 1, 1, 1, 1, 1, 22, 22, 1, 1, 1, 1, 1, 1, 1, 1, 1, 1, 1, 1, 1, 1, 1, 1, 1, 1, 1, 1, 1, 1, 1, 1, 1, 1, 1, 1, 1, 1]
  ],
  "objects": [
    {
      "type": "fire_spawn",
      "row": 26,
      "col": 3
    },
    {
      "type": "water_spawn",
      "row": 26,
      "col": 5
    },
    {
      "type": "diamond",
      "element": "water",
      "row": 26,
      "col": 9
    },
    {
      "type": "diamond",
      "element": "water",
      "row": 22,
      "col": 31
    },
    {
      "type": "diamond",
      "element": "water",
      "row": 18,
      "col": 33
    },
    {
      "type": "diamond",
      "element": "water",
      "row": 2,
      "col": 16
    },
    {
      "type": "diamond",
      "element": "fire",
      "row": 11,
      "col": 2
    },
    {
      "type": "diamond",
      "element": "fire",
      "row": 9,
      "col": 16
    },
    {
      "type": "diamond",
      "element": "fire",
      "row": 20,
      "col": 21
    },
    {
      "type": "fire_door",
      "row": 5,
      "col": 2
    },
    {
      "type": "water_door",
      "row": 6,
      "col": 7
    },
    {
      "type": "timed_button",
      "time": 4000.0,
      "row": 5,
      "col": 36,
      "group_id": 2
    },
    {
      "type": "timed_button",
      "time": 2600.0,
      "row": 15,
      "col": 7
    },
    {
      "type": "lever",
      "row": 19,
      "col": 28,
      "group_id": 5
    },
    {
      "type": "elevator",
      "row": 10,
      "col": 35,
      "target_row": 10,
      "target_col": 38,
      "is_horizontal": true,
      "length": 3,
      "group_id": 5
    },
    {
      "type": "elevator",
      "row": 1,
      "col": 8,
      "target_row": 4,
      "target_col": 8,
      "is_horizontal": false,
      "length": 3,
      "group_id": 2
    },
    {
      "type": "elevator",
      "row": 13,
      "col": 26,
      "target_row": 16,
      "target_col": 26,
      "is_horizontal": false,
      "length": 3
    }
  ]
}